HBD	= "countries/Hudson Bay Directorate.txt"
NFL = "countries/Newfoundland.txt"
PPB = "countries/Providence of Pure Blood.txt"
QUE = "countries/Quebec.txt"
AMT = "countries/American Tsardom.txt"
ARS = "countries/Artic Soviets.txt"
ALD = "countries/Alberta Directorate.txt"
VAS = "countries/Vancouver Soviets.txt"
MTN = "countries/Montana.txt"
SEA = "countries/Seattle.txt"
TEX = "countries/Texas.txt"
ATH = "countries/Athabaska.txt"
FRE = "countries/Freedom Republic.txt"
USA = "countries/USA.txt"
MEX = "countries/Mexico.txt"
RME = "countries/Revolutionary Mexico.txt"
SAI = "countries/New Republic of Saints.txt"
YUC = "countries/Yucat√°n.txt"
HAV = "countries/Havana.txt"
MAR = "countries/Maracaibo.txt"
FRD = "countries/Fordlandia.txt"
ARG = "countries/Argentine Directorate.txt"
CHL = "countries/Chile.txt"
CSB = "countries/Catholic State of Brazil.txt"
NPR = "countries/New Prussia.txt"
PAN = "countries/Panama.txt"
PRU = "countries/Peruvian Empire.txt"
COL = "countries/Columbian State.txt"
RLF = "countries/Revolutionary Liberation Front.txt"
POR = "countries/Portugal.txt"
BSQ = "countries/Basque.txt"
BAL = "countries/Balearic.txt"
EXT = "countries/Extremadura.txt"
CAT = "countries/Catalonia.txt"
FSP = "countries/Falange Spain.txt"
FAI = "countries/CNT FAI.txt"
NSP = "countries/North Spain.txt"
COC = "countries/Communes of Christ.txt"
HEB = "countries/Hebrew.txt"